7 10
3 8
0000111110
1111100010
1330202011
1332020001
1130211011
0111000010
0001111110