13 11
5 6
01111111000
01000001111
01011130001
11000010101
10312020101
10100400101
10102021301
10101000011
10003111011
11110000001
00011111001
00000001001
00000001111