8 10
6 8
1111111110
1333330010
1110201011
0010211001
0012020201
0010001001
0011001001
0001111111